15
35
###################################
#..####....##.#........#..........#
#..#CC#...#CC.#CCCCCCC.#CCCCCCC...#
#..#C#C.#.C#C.#...C....#...C......#
#..#C##C#C..C.#..#C....#...C......#
#..#C##.C###C.=..#C....#...C......#
#..#C#......C.#...C....#...C......#
#..#C#......C.#...C....#...C......#
#..#C#......C.#CCCCCCC.....C......#
#.............#........#=#........#
#...#=#.......#.......#---#.......#
#..#---#......#......#######......#
###################################
